1111111111110011
1111111111110011
1000000000000011
1000000010000011
1000000000100001
1010010010000000
1000000000100001
1000000010000011
1000000000000011
1111111111111111
1111111111111111

2 3