1111111001111111
1111111001111111
1100000000000011
1101001001001011
1100000000000011
1101001001001011
1100000000000011
1101001001001011
1100000000000011
1111111001111111
1111111441111111

0 0