1111111111111111
1111111311111111
1000000000000011
1001111000000001
1000000011100000
1001111000000000
1000000011100000
1001111000000001
1000000000000011
1111111111110011
1111111111110011

3 3