1111111001111111
1111111001111111
1100000000000011
1100100000010011
1100000000000011
0000000000000011
1100000000000011
1100100000010011
1100000000000011
1111111001111111
1111111001111111

4 1