1111111001111111
1111111001111111
1111111000000011
1111111000000111
1111111000000111
0000000000000111
0000000000000111
1110000000000111
1110000000000111
1111111001111111
1111111001111111

3 2