1110101001010101
1110101001010101
1100000000000001
1100001001010101
1010100000000001
0000001001010101
1010000000000001
1100001001010101
1100000000000001
1111111111111111
1111111111111111

2 2