1111111001111111
1111111001111111
1111111000000000
1111111000000000
1111111000101100
1000000000000000
1110000000001100
1110000000000000
1110000000000000
1111111111111111
1111111111111111

2 2