1111111001111111
1111111001111111
0000000000000001
1010001001010001
0000000000000001
1010101001010101
0000000000000001
1010001001010001
0000000000000001
1110101001010101
1110101001010101

3 3