1111111111111111
1111111111111111
1111111111111111
1111111111111111
1111111111111111
1111111000000000
1111111000000000
1111111001111111
1111111001111111
1111111001111111
1111111001111111

0 0