1111111111111111
1111111111111111
1111111111111111
1111111111111111
1111111111111111
1111111111111111
1110000000000011
1110000000000011
1110000000000011
1111111001111111
1111111331111111

0 0