1111111111111111
1111111111111111
1100000000000011
1100101110010011
1100101410010011
1100000000000000
1100010000100011
1100010000100011
1100000000000011
1111111111111111
1111111111111111

0 0