1111111111111111
1111111111111111
0000000000000000
0000000101000101
0000000000000000
0001010101010101
0000000000000000
0000000101000101
0000000000000000
1111111111111111
1111111111111111

3 2