1111111001111111
1111111001111111
1100000000000011
1101100000011011
1100000000000011
1100000110000000
1100000000000000
1101100000011011
1100000000000011
1111111001111111
1111111001111111

2 2