1111111111111111
1111111111111111
1111111000100001
1111111000000001
1111111000001001
0000000000000001
1111111000001001
1111111000000001
1111111000100001
1111111001111111
1111111001111111

9 3